1310312123301103302101311031112322210122
0021223210220321203021011301311100130303
1231301333010022222113302123301030232103
3022132232330330023111002131223201112202
2330233131230112121223333123321022113123
1200220232211322001233002220113322333011
3323100130230123101101332330321302301123
1333020233221200201113231110013022321033
0103030133231313000220330111002313313022
3232301133321212011332113210032213303312
3012100302001232322213320130232102212133
0231130201330302222130203212010301101202
3130203031101300110223303112213000012231
0111203200221331120013012322003013003032
3111231323211221312110333331011221000130
3010121113330010101232130112103001333100
0123013021101310013112200233103311112312
3132233030011131012310200221000223201323
2210023121122122031211112322223120301212
2113202333331331111222130023031301020301
